MOT = "countries/Mondstad.txt"
LYU = "countries/Liyue.txt"
INA = "countries/Inazuma.txt"
SNA = "countries/Sangonomiya.txt"
ABY = "countries/Abyss.txt"
CEL = "countries/Celestial.txt"
KQG = "countries/Keqing.txt"
SNE = "countries/Snezhnaya.txt"
FDP = "countries/WitchAssociationOp.txt"
XFH = "countries/FavoniusChurch.txt"
MDW = "countries/MondResidentsCommittee.txt"
YLP = "countries/YLP.txt"
SUM = "countries/Sumeru.txt"
KUJ = "countries/KujoMilitaryJunta.txt"
RIT = "countries/RitouSpecialEconomicZone.txt"
NAR = "countries/NarukamiAutonomousRegions.txt"
FRO = "countries/FontaineResistance.txt"
KMR = "countries/KamisatoRegion.txt"
AVH = "countries/InazumaAntiVisionHunt.txt"
RDS = "countries/RaidenShogun.txt"
DSC = "countries/Dragonsprine.txt"
MXJ = "countries/BraveAssociation.txt"
FLF = "countries/lieshouAlliance.txt"
FON = "countries/Fontaine.txt"
NAT = "countries/Natlan.txt"
ZDG = "countries/Zhidong.txt"
QCB = "countries/knighthoodRemnants.txt"
MDQ = "countries/QQtribe.txt"
GAP = "countries/GoldenAppleArchipelago.txt"
LLS = "countries/Lawrence.txt"
GTG = "countries/StormChurch.txt"
QST = "countries/knighthoodOpposition.txt"
ALS = "countries/WitchAssociation.txt"
DBT = "countries/MondTreasureHoarders.txt"
JGW = "countries/MondMAC.txt"
ZDD = "countries/SnezhnayaExpedition.txt"
HBD = "countries/Dragonspine.txt"
FDN = "countries/Findnier.txt"
LXG = "countries/AbyssWolves.txt"
SLM = "countries/LeyLineArea.txt"
HTG = "countries/Hutao.txt"
ANG = "countries/Anren.txt"
RTG = "countries/Ruotuo.txt"
XRG = "countries/Xianren.txt"
SHG = "countries/Shenhe.txt"
XOG = "countries/Xiao.txt"
XQG = "countries/Xingqiu.txt"
BDG = "countries/Beidou.txt"
BLL = "countries/Benlangling.txt"
NNG = "countries/Ningguang.txt"
DLK = "countries/Diluke.txt"
TWL = "countries/Tewalin.txt"
HIL = "countries/Hilichurls.txt"
ANB = "countries/InvestigationnKnights.txt"
BBT = "countries/MondFreedomArmy.txt"
FXE = "countries/holyMond.txt"
MYZ = "countries/MondFatuus.txt"
QQZ = "countries/SpringvaleAN.txt"
YZJ = "countries/MondExpeditioaryForce.txt"
NSN = "countries/Neoshogun.txt"
HYN = "countries/Yoimiya.txt"
ORB = "countries/奥罗巴斯国.txt"
BBY = "countries/YashioriIsland.txt"
WYG = "countries/HomecomingRonin.txt"
SBG = "countries/FatuusRebelForces.txt"
SAN = "countries/SangonomiyaShrine.txt"
TBS = "countries/Tatarasuna.txt"
NNA = "countries/NeoYae.txt"
WLC = "countries/Bourou.txt"
JYG = "countries/jianyuG.txt"
RIE = "countries/RitouSurvivors.txt"
ARI = "countries/Araumi.txt"
EKM = "countries/Enkanomiya.txt"
SRI = "countries/Seirai_Island.txt"
TRM = "countries/Tsurumi_Island.txt"
SUD = "countries/Sumeru_Desert.txt"
ARF = "countries/Abyss_Resistance_Force.txt"

##########################
EMP = "countries/EmptyNation.txt"
NIE = "countries/Narukami_Island_empty.txt"
CUG = "countries/Chasm_underground.txt"